"a" = (/turf/wall,/area)
"b" = (/turf/floor,/area)
"c" = (/turf/floor/super,/area)

(1,1,1) = {"
aaaaaaaaaa
abbbbbbbba
abbbbbaaaa
abbbbbabba
abbbcbabba
abbbbbabba
abbbbbabba
abbbbbbbba
abbbbbbbba
aaaaaaaaaa
"}
